"Tiedot";"Vuosi";"Alue";"Puolue";"Yhteensä";"Miehet";"Naiset"
"Ehdokkaiden lukumäärä";"2021";"091 Helsinki";"Yhteensä";1163;631;532
"Ehdokkaiden lukumäärä";"2021";"049 Espoo";"Yhteensä";772;429;343
"Ehdokkaiden lukumäärä";"2021";"078 Hanko";"Yhteensä";95;64;31
"Ehdokkaiden lukumäärä";"2021";"092 Vantaa";"Yhteensä";690;393;297
"Ehdokkaiden lukumäärä";"2021";"106 Hyvinkää";"Yhteensä";322;198;124
"Ehdokkaiden lukumäärä";"2021";"186 Järvenpää";"Yhteensä";309;196;113
"Ehdokkaiden lukumäärä";"2021";"235 Kauniainen";"Yhteensä";118;64;54
"Ehdokkaiden lukumäärä";"2021";"245 Kerava";"Yhteensä";265;138;127
"Ehdokkaiden lukumäärä";"2021";"257 Kirkkonummi";"Yhteensä";280;173;107
"Ehdokkaiden lukumäärä";"2021";"444 Lohja";"Yhteensä";400;218;182
"Ehdokkaiden lukumäärä";"2021";"543 Nurmijärvi";"Yhteensä";239;144;95
"Ehdokkaiden lukumäärä";"2021";"638 Porvoo";"Yhteensä";317;168;149
"Ehdokkaiden lukumäärä";"2021";"858 Tuusula";"Yhteensä";308;178;130
"Ehdokkaiden lukumäärä";"2021";"224 Karkkila";"Yhteensä";100;55;45
"Ehdokkaiden lukumäärä";"2021";"434 Loviisa";"Yhteensä";133;74;59
"Ehdokkaiden lukumäärä";"2021";"505 Mäntsälä";"Yhteensä";192;117;75
"Ehdokkaiden lukumäärä";"2021";"710 Raasepori";"Yhteensä";174;93;81
"Ehdokkaiden lukumäärä";"2021";"753 Sipoo";"Yhteensä";190;105;85
"Ehdokkaiden lukumäärä";"2021";"927 Vihti";"Yhteensä";215;126;89
"Ehdokkaiden lukumäärä";"2021";"018 Askola";"Yhteensä";65;37;28
"Ehdokkaiden lukumäärä";"2021";"149 Inkoo";"Yhteensä";74;41;33
"Ehdokkaiden lukumäärä";"2021";"407 Lapinjärvi";"Yhteensä";42;24;18
"Ehdokkaiden lukumäärä";"2021";"504 Myrskylä";"Yhteensä";56;29;27
"Ehdokkaiden lukumäärä";"2021";"611 Pornainen";"Yhteensä";67;31;36
"Ehdokkaiden lukumäärä";"2021";"616 Pukkila";"Yhteensä";38;23;15
"Ehdokkaiden lukumäärä";"2021";"755 Siuntio";"Yhteensä";93;60;33
"Ehdokkaiden lukumäärä";"2021";"202 Kaarina";"Yhteensä";246;138;108
"Ehdokkaiden lukumäärä";"2021";"680 Raisio";"Yhteensä";223;129;94
"Ehdokkaiden lukumäärä";"2021";"734 Salo";"Yhteensä";343;191;152
"Ehdokkaiden lukumäärä";"2021";"853 Turku";"Yhteensä";669;374;295
"Ehdokkaiden lukumäärä";"2021";"400 Laitila";"Yhteensä";83;52;31
"Ehdokkaiden lukumäärä";"2021";"423 Lieto";"Yhteensä";193;112;81
"Ehdokkaiden lukumäärä";"2021";"430 Loimaa";"Yhteensä";150;90;60
"Ehdokkaiden lukumäärä";"2021";"445 Parainen";"Yhteensä";156;83;73
"Ehdokkaiden lukumäärä";"2021";"481 Masku";"Yhteensä";107;58;49
"Ehdokkaiden lukumäärä";"2021";"503 Mynämäki";"Yhteensä";71;44;27
"Ehdokkaiden lukumäärä";"2021";"529 Naantali";"Yhteensä";230;137;93
"Ehdokkaiden lukumäärä";"2021";"577 Paimio";"Yhteensä";119;71;48
"Ehdokkaiden lukumäärä";"2021";"895 Uusikaupunki";"Yhteensä";126;82;44
"Ehdokkaiden lukumäärä";"2021";"019 Aura";"Yhteensä";53;30;23
"Ehdokkaiden lukumäärä";"2021";"284 Koski Tl";"Yhteensä";41;29;12
"Ehdokkaiden lukumäärä";"2021";"304 Kustavi";"Yhteensä";37;19;18
"Ehdokkaiden lukumäärä";"2021";"322 Kemiönsaari";"Yhteensä";84;48;36
"Ehdokkaiden lukumäärä";"2021";"480 Marttila";"Yhteensä";52;34;18
"Ehdokkaiden lukumäärä";"2021";"538 Nousiainen";"Yhteensä";60;35;25
"Ehdokkaiden lukumäärä";"2021";"561 Oripää";"Yhteensä";38;21;17
"Ehdokkaiden lukumäärä";"2021";"631 Pyhäranta";"Yhteensä";37;17;20
"Ehdokkaiden lukumäärä";"2021";"636 Pöytyä";"Yhteensä";102;54;48
"Ehdokkaiden lukumäärä";"2021";"704 Rusko";"Yhteensä";92;54;38
"Ehdokkaiden lukumäärä";"2021";"738 Sauvo";"Yhteensä";81;44;37
"Ehdokkaiden lukumäärä";"2021";"761 Somero";"Yhteensä";91;56;35
"Ehdokkaiden lukumäärä";"2021";"833 Taivassalo";"Yhteensä";36;19;17
"Ehdokkaiden lukumäärä";"2021";"918 Vehmaa";"Yhteensä";49;26;23
"Ehdokkaiden lukumäärä";"2021";"079 Harjavalta";"Yhteensä";82;53;29
"Ehdokkaiden lukumäärä";"2021";"609 Pori";"Yhteensä";410;238;172
"Ehdokkaiden lukumäärä";"2021";"684 Rauma";"Yhteensä";194;125;69
"Ehdokkaiden lukumäärä";"2021";"050 Eura";"Yhteensä";132;82;50
"Ehdokkaiden lukumäärä";"2021";"102 Huittinen";"Yhteensä";110;66;44
"Ehdokkaiden lukumäärä";"2021";"214 Kankaanpää";"Yhteensä";161;101;60
"Ehdokkaiden lukumäärä";"2021";"886 Ulvila";"Yhteensä";121;78;43
"Ehdokkaiden lukumäärä";"2021";"051 Eurajoki";"Yhteensä";128;77;51
"Ehdokkaiden lukumäärä";"2021";"181 Jämijärvi";"Yhteensä";28;20;8
"Ehdokkaiden lukumäärä";"2021";"230 Karvia";"Yhteensä";49;28;21
"Ehdokkaiden lukumäärä";"2021";"271 Kokemäki";"Yhteensä";102;64;38
"Ehdokkaiden lukumäärä";"2021";"484 Merikarvia";"Yhteensä";35;23;12
"Ehdokkaiden lukumäärä";"2021";"531 Nakkila";"Yhteensä";81;47;34
"Ehdokkaiden lukumäärä";"2021";"608 Pomarkku";"Yhteensä";54;32;22
"Ehdokkaiden lukumäärä";"2021";"747 Siikainen";"Yhteensä";39;21;18
"Ehdokkaiden lukumäärä";"2021";"783 Säkylä";"Yhteensä";90;57;33
"Ehdokkaiden lukumäärä";"2021";"061 Forssa";"Yhteensä";173;98;75
"Ehdokkaiden lukumäärä";"2021";"098 Hollola";"Yhteensä";148;93;55
"Ehdokkaiden lukumäärä";"2021";"109 Hämeenlinna";"Yhteensä";343;203;140
"Ehdokkaiden lukumäärä";"2021";"111 Heinola";"Yhteensä";177;105;72
"Ehdokkaiden lukumäärä";"2021";"398 Lahti";"Yhteensä";544;342;202
"Ehdokkaiden lukumäärä";"2021";"694 Riihimäki";"Yhteensä";209;112;97
"Ehdokkaiden lukumäärä";"2021";"016 Asikkala";"Yhteensä";88;55;33
"Ehdokkaiden lukumäärä";"2021";"082 Hattula";"Yhteensä";82;48;34
"Ehdokkaiden lukumäärä";"2021";"165 Janakkala";"Yhteensä";166;91;75
"Ehdokkaiden lukumäärä";"2021";"560 Orimattila";"Yhteensä";130;82;48
"Ehdokkaiden lukumäärä";"2021";"081 Hartola";"Yhteensä";51;34;17
"Ehdokkaiden lukumäärä";"2021";"086 Hausjärvi";"Yhteensä";89;48;41
"Ehdokkaiden lukumäärä";"2021";"103 Humppila";"Yhteensä";46;30;16
"Ehdokkaiden lukumäärä";"2021";"142 Iitti";"Yhteensä";66;39;27
"Ehdokkaiden lukumäärä";"2021";"169 Jokioinen";"Yhteensä";80;39;41
"Ehdokkaiden lukumäärä";"2021";"316 Kärkölä";"Yhteensä";64;47;17
"Ehdokkaiden lukumäärä";"2021";"433 Loppi";"Yhteensä";113;59;54
"Ehdokkaiden lukumäärä";"2021";"576 Padasjoki";"Yhteensä";56;36;20
"Ehdokkaiden lukumäärä";"2021";"781 Sysmä";"Yhteensä";64;34;30
"Ehdokkaiden lukumäärä";"2021";"834 Tammela";"Yhteensä";81;52;29
"Ehdokkaiden lukumäärä";"2021";"981 Ypäjä";"Yhteensä";66;35;31
"Ehdokkaiden lukumäärä";"2021";"211 Kangasala";"Yhteensä";227;137;90
"Ehdokkaiden lukumäärä";"2021";"418 Lempäälä";"Yhteensä";190;107;83
"Ehdokkaiden lukumäärä";"2021";"536 Nokia";"Yhteensä";271;169;102
"Ehdokkaiden lukumäärä";"2021";"604 Pirkkala";"Yhteensä";191;115;76
"Ehdokkaiden lukumäärä";"2021";"837 Tampere";"Yhteensä";651;366;285
"Ehdokkaiden lukumäärä";"2021";"908 Valkeakoski";"Yhteensä";164;99;65
"Ehdokkaiden lukumäärä";"2021";"980 Ylöjärvi";"Yhteensä";199;114;85
"Ehdokkaiden lukumäärä";"2021";"020 Akaa";"Yhteensä";164;103;61
"Ehdokkaiden lukumäärä";"2021";"108 Hämeenkyrö";"Yhteensä";108;65;43
"Ehdokkaiden lukumäärä";"2021";"508 Mänttä-Vilppula";"Yhteensä";83;51;32
"Ehdokkaiden lukumäärä";"2021";"562 Orivesi";"Yhteensä";118;63;55
"Ehdokkaiden lukumäärä";"2021";"581 Parkano";"Yhteensä";103;71;32
"Ehdokkaiden lukumäärä";"2021";"790 Sastamala";"Yhteensä";173;107;66
"Ehdokkaiden lukumäärä";"2021";"143 Ikaalinen";"Yhteensä";88;55;33
"Ehdokkaiden lukumäärä";"2021";"177 Juupajoki";"Yhteensä";34;17;17
"Ehdokkaiden lukumäärä";"2021";"250 Kihniö";"Yhteensä";42;21;21
"Ehdokkaiden lukumäärä";"2021";"291 Kuhmoinen";"Yhteensä";42;25;17
"Ehdokkaiden lukumäärä";"2021";"619 Punkalaidun";"Yhteensä";46;31;15
"Ehdokkaiden lukumäärä";"2021";"635 Pälkäne";"Yhteensä";89;52;37
"Ehdokkaiden lukumäärä";"2021";"702 Ruovesi";"Yhteensä";67;31;36
"Ehdokkaiden lukumäärä";"2021";"887 Urjala";"Yhteensä";52;30;22
"Ehdokkaiden lukumäärä";"2021";"922 Vesilahti";"Yhteensä";52;25;27
"Ehdokkaiden lukumäärä";"2021";"936 Virrat";"Yhteensä";74;41;33
"Ehdokkaiden lukumäärä";"2021";"075 Hamina";"Yhteensä";138;91;47
"Ehdokkaiden lukumäärä";"2021";"153 Imatra";"Yhteensä";192;122;70
"Ehdokkaiden lukumäärä";"2021";"285 Kotka";"Yhteensä";320;203;117
"Ehdokkaiden lukumäärä";"2021";"286 Kouvola";"Yhteensä";369;236;133
"Ehdokkaiden lukumäärä";"2021";"405 Lappeenranta";"Yhteensä";347;230;117
"Ehdokkaiden lukumäärä";"2021";"491 Mikkeli";"Yhteensä";288;183;105
"Ehdokkaiden lukumäärä";"2021";"740 Savonlinna";"Yhteensä";199;137;62
"Ehdokkaiden lukumäärä";"2021";"593 Pieksämäki";"Yhteensä";129;85;44
"Ehdokkaiden lukumäärä";"2021";"046 Enonkoski";"Yhteensä";31;22;9
"Ehdokkaiden lukumäärä";"2021";"097 Hirvensalmi";"Yhteensä";46;32;14
"Ehdokkaiden lukumäärä";"2021";"178 Juva";"Yhteensä";59;36;23
"Ehdokkaiden lukumäärä";"2021";"213 Kangasniemi";"Yhteensä";64;36;28
"Ehdokkaiden lukumäärä";"2021";"416 Lemi";"Yhteensä";43;26;17
"Ehdokkaiden lukumäärä";"2021";"441 Luumäki";"Yhteensä";69;44;25
"Ehdokkaiden lukumäärä";"2021";"489 Miehikkälä";"Yhteensä";43;23;20
"Ehdokkaiden lukumäärä";"2021";"507 Mäntyharju";"Yhteensä";90;55;35
"Ehdokkaiden lukumäärä";"2021";"580 Parikkala";"Yhteensä";81;48;33
"Ehdokkaiden lukumäärä";"2021";"588 Pertunmaa";"Yhteensä";38;23;15
"Ehdokkaiden lukumäärä";"2021";"623 Puumala";"Yhteensä";40;26;14
"Ehdokkaiden lukumäärä";"2021";"624 Pyhtää";"Yhteensä";62;38;24
"Ehdokkaiden lukumäärä";"2021";"681 Rantasalmi";"Yhteensä";44;28;16
"Ehdokkaiden lukumäärä";"2021";"689 Rautjärvi";"Yhteensä";48;35;13
"Ehdokkaiden lukumäärä";"2021";"700 Ruokolahti";"Yhteensä";63;33;30
"Ehdokkaiden lukumäärä";"2021";"739 Savitaipale";"Yhteensä";57;36;21
"Ehdokkaiden lukumäärä";"2021";"768 Sulkava";"Yhteensä";43;23;20
"Ehdokkaiden lukumäärä";"2021";"831 Taipalsaari";"Yhteensä";49;25;24
"Ehdokkaiden lukumäärä";"2021";"935 Virolahti";"Yhteensä";47;24;23
"Ehdokkaiden lukumäärä";"2021";"140 Iisalmi";"Yhteensä";154;92;62
"Ehdokkaiden lukumäärä";"2021";"167 Joensuu";"Yhteensä";477;301;176
"Ehdokkaiden lukumäärä";"2021";"297 Kuopio";"Yhteensä";507;316;191
"Ehdokkaiden lukumäärä";"2021";"915 Varkaus";"Yhteensä";147;96;51
"Ehdokkaiden lukumäärä";"2021";"276 Kontiolahti";"Yhteensä";132;79;53
"Ehdokkaiden lukumäärä";"2021";"309 Outokumpu";"Yhteensä";111;71;40
"Ehdokkaiden lukumäärä";"2021";"422 Lieksa";"Yhteensä";113;71;42
"Ehdokkaiden lukumäärä";"2021";"541 Nurmes";"Yhteensä";122;81;41
"Ehdokkaiden lukumäärä";"2021";"749 Siilinjärvi";"Yhteensä";145;98;47
"Ehdokkaiden lukumäärä";"2021";"778 Suonenjoki";"Yhteensä";83;53;30
"Ehdokkaiden lukumäärä";"2021";"090 Heinävesi";"Yhteensä";57;36;21
"Ehdokkaiden lukumäärä";"2021";"146 Ilomantsi";"Yhteensä";56;33;23
"Ehdokkaiden lukumäärä";"2021";"171 Joroinen";"Yhteensä";49;27;22
"Ehdokkaiden lukumäärä";"2021";"176 Juuka";"Yhteensä";71;47;24
"Ehdokkaiden lukumäärä";"2021";"204 Kaavi";"Yhteensä";49;30;19
"Ehdokkaiden lukumäärä";"2021";"239 Keitele";"Yhteensä";44;28;16
"Ehdokkaiden lukumäärä";"2021";"260 Kitee";"Yhteensä";120;80;40
"Ehdokkaiden lukumäärä";"2021";"263 Kiuruvesi";"Yhteensä";109;75;34
"Ehdokkaiden lukumäärä";"2021";"402 Lapinlahti";"Yhteensä";134;77;57
"Ehdokkaiden lukumäärä";"2021";"420 Leppävirta";"Yhteensä";101;62;39
"Ehdokkaiden lukumäärä";"2021";"426 Liperi";"Yhteensä";111;70;41
"Ehdokkaiden lukumäärä";"2021";"595 Pielavesi";"Yhteensä";68;43;25
"Ehdokkaiden lukumäärä";"2021";"607 Polvijärvi";"Yhteensä";69;41;28
"Ehdokkaiden lukumäärä";"2021";"686 Rautalampi";"Yhteensä";56;33;23
"Ehdokkaiden lukumäärä";"2021";"687 Rautavaara";"Yhteensä";28;17;11
"Ehdokkaiden lukumäärä";"2021";"707 Rääkkylä";"Yhteensä";56;36;20
"Ehdokkaiden lukumäärä";"2021";"762 Sonkajärvi";"Yhteensä";51;29;22
"Ehdokkaiden lukumäärä";"2021";"844 Tervo";"Yhteensä";31;19;12
"Ehdokkaiden lukumäärä";"2021";"848 Tohmajärvi";"Yhteensä";70;46;24
"Ehdokkaiden lukumäärä";"2021";"857 Tuusniemi";"Yhteensä";59;33;26
"Ehdokkaiden lukumäärä";"2021";"921 Vesanto";"Yhteensä";45;25;20
"Ehdokkaiden lukumäärä";"2021";"925 Vieremä";"Yhteensä";51;36;15
"Ehdokkaiden lukumäärä";"2021";"231 Kaskinen";"Yhteensä";49;28;21
"Ehdokkaiden lukumäärä";"2021";"272 Kokkola";"Yhteensä";353;216;137
"Ehdokkaiden lukumäärä";"2021";"598 Pietarsaari";"Yhteensä";148;90;58
"Ehdokkaiden lukumäärä";"2021";"743 Seinäjoki";"Yhteensä";320;201;119
"Ehdokkaiden lukumäärä";"2021";"905 Vaasa";"Yhteensä";382;232;150
"Ehdokkaiden lukumäärä";"2021";"005 Alajärvi";"Yhteensä";112;73;39
"Ehdokkaiden lukumäärä";"2021";"010 Alavus";"Yhteensä";132;85;47
"Ehdokkaiden lukumäärä";"2021";"145 Ilmajoki";"Yhteensä";109;62;47
"Ehdokkaiden lukumäärä";"2021";"232 Kauhajoki";"Yhteensä";132;98;34
"Ehdokkaiden lukumäärä";"2021";"233 Kauhava";"Yhteensä";155;95;60
"Ehdokkaiden lukumäärä";"2021";"301 Kurikka";"Yhteensä";195;120;75
"Ehdokkaiden lukumäärä";"2021";"399 Laihia";"Yhteensä";81;57;24
"Ehdokkaiden lukumäärä";"2021";"408 Lapua";"Yhteensä";144;85;59
"Ehdokkaiden lukumäärä";"2021";"499 Mustasaari";"Yhteensä";109;71;38
"Ehdokkaiden lukumäärä";"2021";"052 Evijärvi";"Yhteensä";33;27;6
"Ehdokkaiden lukumäärä";"2021";"074 Halsua";"Yhteensä";26;17;9
"Ehdokkaiden lukumäärä";"2021";"151 Isojoki";"Yhteensä";40;30;10
"Ehdokkaiden lukumäärä";"2021";"152 Isokyrö";"Yhteensä";87;54;33
"Ehdokkaiden lukumäärä";"2021";"217 Kannus";"Yhteensä";75;47;28
"Ehdokkaiden lukumäärä";"2021";"218 Karijoki";"Yhteensä";30;18;12
"Ehdokkaiden lukumäärä";"2021";"236 Kaustinen";"Yhteensä";65;39;26
"Ehdokkaiden lukumäärä";"2021";"280 Korsnäs";"Yhteensä";33;21;12
"Ehdokkaiden lukumäärä";"2021";"287 Kristiinankaupunki";"Yhteensä";65;40;25
"Ehdokkaiden lukumäärä";"2021";"288 Kruunupyy";"Yhteensä";59;33;26
"Ehdokkaiden lukumäärä";"2021";"300 Kuortane";"Yhteensä";64;40;24
"Ehdokkaiden lukumäärä";"2021";"403 Lappajärvi";"Yhteensä";44;31;13
"Ehdokkaiden lukumäärä";"2021";"421 Lestijärvi";"Yhteensä";24;16;8
"Ehdokkaiden lukumäärä";"2021";"440 Luoto";"Yhteensä";76;46;30
"Ehdokkaiden lukumäärä";"2021";"475 Maalahti";"Yhteensä";69;39;30
"Ehdokkaiden lukumäärä";"2021";"545 Närpiö";"Yhteensä";62;35;27
"Ehdokkaiden lukumäärä";"2021";"584 Perho";"Yhteensä";36;26;10
"Ehdokkaiden lukumäärä";"2021";"599 Pedersören kunta";"Yhteensä";102;58;44
"Ehdokkaiden lukumäärä";"2021";"759 Soini";"Yhteensä";41;21;20
"Ehdokkaiden lukumäärä";"2021";"846 Teuva";"Yhteensä";77;46;31
"Ehdokkaiden lukumäärä";"2021";"849 Toholampi";"Yhteensä";29;20;9
"Ehdokkaiden lukumäärä";"2021";"893 Uusikaarlepyy";"Yhteensä";59;29;30
"Ehdokkaiden lukumäärä";"2021";"924 Veteli";"Yhteensä";48;32;16
"Ehdokkaiden lukumäärä";"2021";"934 Vimpeli";"Yhteensä";62;40;22
"Ehdokkaiden lukumäärä";"2021";"946 Vöyri";"Yhteensä";44;28;16
"Ehdokkaiden lukumäärä";"2021";"989 Ähtäri";"Yhteensä";79;48;31
"Ehdokkaiden lukumäärä";"2021";"179 Jyväskylä";"Yhteensä";611;377;234
"Ehdokkaiden lukumäärä";"2021";"182 Jämsä";"Yhteensä";154;108;46
"Ehdokkaiden lukumäärä";"2021";"249 Keuruu";"Yhteensä";86;57;29
"Ehdokkaiden lukumäärä";"2021";"410 Laukaa";"Yhteensä";127;88;39
"Ehdokkaiden lukumäärä";"2021";"500 Muurame";"Yhteensä";85;52;33
"Ehdokkaiden lukumäärä";"2021";"992 Äänekoski";"Yhteensä";124;82;42
"Ehdokkaiden lukumäärä";"2021";"077 Hankasalmi";"Yhteensä";55;33;22
"Ehdokkaiden lukumäärä";"2021";"172 Joutsa";"Yhteensä";53;34;19
"Ehdokkaiden lukumäärä";"2021";"216 Kannonkoski";"Yhteensä";26;17;9
"Ehdokkaiden lukumäärä";"2021";"226 Karstula";"Yhteensä";54;30;24
"Ehdokkaiden lukumäärä";"2021";"256 Kinnula";"Yhteensä";42;27;15
"Ehdokkaiden lukumäärä";"2021";"265 Kivijärvi";"Yhteensä";23;16;7
"Ehdokkaiden lukumäärä";"2021";"275 Konnevesi";"Yhteensä";30;17;13
"Ehdokkaiden lukumäärä";"2021";"312 Kyyjärvi";"Yhteensä";29;21;8
"Ehdokkaiden lukumäärä";"2021";"435 Luhanka";"Yhteensä";25;18;7
"Ehdokkaiden lukumäärä";"2021";"495 Multia";"Yhteensä";24;14;10
"Ehdokkaiden lukumäärä";"2021";"592 Petäjävesi";"Yhteensä";70;45;25
"Ehdokkaiden lukumäärä";"2021";"601 Pihtipudas";"Yhteensä";69;39;30
"Ehdokkaiden lukumäärä";"2021";"729 Saarijärvi";"Yhteensä";105;71;34
"Ehdokkaiden lukumäärä";"2021";"850 Toivakka";"Yhteensä";51;28;23
"Ehdokkaiden lukumäärä";"2021";"892 Uurainen";"Yhteensä";58;38;20
"Ehdokkaiden lukumäärä";"2021";"931 Viitasaari";"Yhteensä";90;57;33
"Ehdokkaiden lukumäärä";"2021";"205 Kajaani";"Yhteensä";259;176;83
"Ehdokkaiden lukumäärä";"2021";"244 Kempele";"Yhteensä";112;62;50
"Ehdokkaiden lukumäärä";"2021";"564 Oulu";"Yhteensä";670;405;265
"Ehdokkaiden lukumäärä";"2021";"678 Raahe";"Yhteensä";162;103;59
"Ehdokkaiden lukumäärä";"2021";"069 Haapajärvi";"Yhteensä";78;53;25
"Ehdokkaiden lukumäärä";"2021";"139 Ii";"Yhteensä";78;44;34
"Ehdokkaiden lukumäärä";"2021";"208 Kalajoki";"Yhteensä";96;59;37
"Ehdokkaiden lukumäärä";"2021";"290 Kuhmo";"Yhteensä";89;56;33
"Ehdokkaiden lukumäärä";"2021";"305 Kuusamo";"Yhteensä";142;93;49
"Ehdokkaiden lukumäärä";"2021";"425 Liminka";"Yhteensä";81;55;26
"Ehdokkaiden lukumäärä";"2021";"494 Muhos";"Yhteensä";80;54;26
"Ehdokkaiden lukumäärä";"2021";"535 Nivala";"Yhteensä";85;51;34
"Ehdokkaiden lukumäärä";"2021";"563 Oulainen";"Yhteensä";76;49;27
"Ehdokkaiden lukumäärä";"2021";"765 Sotkamo";"Yhteensä";123;75;48
"Ehdokkaiden lukumäärä";"2021";"977 Ylivieska";"Yhteensä";120;78;42
"Ehdokkaiden lukumäärä";"2021";"009 Alavieska";"Yhteensä";42;31;11
"Ehdokkaiden lukumäärä";"2021";"071 Haapavesi";"Yhteensä";88;59;29
"Ehdokkaiden lukumäärä";"2021";"072 Hailuoto";"Yhteensä";37;23;14
"Ehdokkaiden lukumäärä";"2021";"105 Hyrynsalmi";"Yhteensä";35;21;14
"Ehdokkaiden lukumäärä";"2021";"317 Kärsämäki";"Yhteensä";46;28;18
"Ehdokkaiden lukumäärä";"2021";"436 Lumijoki";"Yhteensä";28;18;10
"Ehdokkaiden lukumäärä";"2021";"483 Merijärvi";"Yhteensä";21;11;10
"Ehdokkaiden lukumäärä";"2021";"578 Paltamo";"Yhteensä";44;24;20
"Ehdokkaiden lukumäärä";"2021";"615 Pudasjärvi";"Yhteensä";99;58;41
"Ehdokkaiden lukumäärä";"2021";"620 Puolanka";"Yhteensä";41;24;17
"Ehdokkaiden lukumäärä";"2021";"625 Pyhäjoki";"Yhteensä";46;25;21
"Ehdokkaiden lukumäärä";"2021";"626 Pyhäjärvi";"Yhteensä";57;38;19
"Ehdokkaiden lukumäärä";"2021";"630 Pyhäntä";"Yhteensä";34;20;14
"Ehdokkaiden lukumäärä";"2021";"691 Reisjärvi";"Yhteensä";36;23;13
"Ehdokkaiden lukumäärä";"2021";"697 Ristijärvi";"Yhteensä";27;15;12
"Ehdokkaiden lukumäärä";"2021";"746 Sievi";"Yhteensä";56;36;20
"Ehdokkaiden lukumäärä";"2021";"748 Siikajoki";"Yhteensä";58;37;21
"Ehdokkaiden lukumäärä";"2021";"777 Suomussalmi";"Yhteensä";89;64;25
"Ehdokkaiden lukumäärä";"2021";"785 Vaala";"Yhteensä";64;41;23
"Ehdokkaiden lukumäärä";"2021";"791 Siikalatva";"Yhteensä";52;33;19
"Ehdokkaiden lukumäärä";"2021";"832 Taivalkoski";"Yhteensä";64;43;21
"Ehdokkaiden lukumäärä";"2021";"859 Tyrnävä";"Yhteensä";76;39;37
"Ehdokkaiden lukumäärä";"2021";"889 Utajärvi";"Yhteensä";60;34;26
"Ehdokkaiden lukumäärä";"2021";"240 Kemi";"Yhteensä";168;99;69
"Ehdokkaiden lukumäärä";"2021";"698 Rovaniemi";"Yhteensä";342;198;144
"Ehdokkaiden lukumäärä";"2021";"851 Tornio";"Yhteensä";163;100;63
"Ehdokkaiden lukumäärä";"2021";"241 Keminmaa";"Yhteensä";109;61;48
"Ehdokkaiden lukumäärä";"2021";"320 Kemijärvi";"Yhteensä";79;56;23
"Ehdokkaiden lukumäärä";"2021";"758 Sodankylä";"Yhteensä";92;61;31
"Ehdokkaiden lukumäärä";"2021";"047 Enontekiö";"Yhteensä";43;25;18
"Ehdokkaiden lukumäärä";"2021";"148 Inari";"Yhteensä";79;46;33
"Ehdokkaiden lukumäärä";"2021";"261 Kittilä";"Yhteensä";83;52;31
"Ehdokkaiden lukumäärä";"2021";"273 Kolari";"Yhteensä";67;45;22
"Ehdokkaiden lukumäärä";"2021";"498 Muonio";"Yhteensä";33;21;12
"Ehdokkaiden lukumäärä";"2021";"583 Pelkosenniemi";"Yhteensä";23;16;7
"Ehdokkaiden lukumäärä";"2021";"614 Posio";"Yhteensä";38;21;17
"Ehdokkaiden lukumäärä";"2021";"683 Ranua";"Yhteensä";63;40;23
"Ehdokkaiden lukumäärä";"2021";"732 Salla";"Yhteensä";48;28;20
"Ehdokkaiden lukumäärä";"2021";"742 Savukoski";"Yhteensä";32;20;12
"Ehdokkaiden lukumäärä";"2021";"751 Simo";"Yhteensä";36;22;14
"Ehdokkaiden lukumäärä";"2021";"845 Tervola";"Yhteensä";49;35;14
"Ehdokkaiden lukumäärä";"2021";"854 Pello";"Yhteensä";45;25;20
"Ehdokkaiden lukumäärä";"2021";"890 Utsjoki";"Yhteensä";46;32;14
"Ehdokkaiden lukumäärä";"2021";"976 Ylitornio";"Yhteensä";56;30;26
